####
#  ##############
#  #   **#******#
#  # # ##### ***#
##X#    ********#
#   ##X######  ####
# X #     ######@ #
##X # X   ######  #
#  X #XXX##       #
#      #    #X#X###
# #### #XXXXX    #
# #    X     #   #
# #   ##        ###
# ######X###### X #
#        #    #   #
##########    #####