#########
#       #
#       ####
## #### #  #
## #@##    #
# XXX X  XX#
#  # ## X  #
#  # ##  X ####
####  XXX X#  #
 #   ##   ****#
 # #   # #** *#
 #   # # ##***#
 ##### X  #***#
     ##   #####
      #####