 ###########
 #     ##  #
 #   X   X #
#### ## XX #
#   X #    #
# XXX # ####
#   # # X ##
#  #  #  X #
# X# X#    #
#   **# ####
####** X #@#
#*****# X# #
##****#  X #
 ##**##    #
  ##########