           #####
          ##   ##
         ##     #
        ##  XX  #
       ## XX  X #
       # X    X #
####   #   XX #####
#  ######## ##    #
#*            XXX@#
#*# ####### ##   ##
#*# #######* #X X##
#*********** #    #
##############  X #
             ##  ##
              ####