           ########
           #  ****#
############  ****#
#    #  X X   ****#
# XXX#X  X #  ****#
#  X     X #  ****#
# XX #X X X########
#  X #     #
## #########
#    #    ##
#     X   ##
#  XX#XX  @#
#    #    ##
###########