          ####
     #### #  #
   ### @###X #
  ##      X  #
 ##  X XX## ##
 #  #X##     #
 # # X XX # ###
 #   X #  # X #####
####    #  XX #   #
#### ## X         #
#*    ###  ########
#** **# ####
#***#*#
#*****#
#######