             ######
 #############****#
##   ##     ##****#
#  XX##  X @##****#
#      XX X#  ****#
#  X ## XX # # ***#
#  X ## X  #  ****#
## ##### ### ##*###
##   X  X ##   *  #
# X###  # ##### ###
#   X   #       #
#  X #X X X###  #
# XXX# X   # ####
#    #  XX #
######   ###
     #####