 ###  #############
##@####       #   #
# XX   XX  X X ***#
#  XXX#    X  #***#
# X   # XX XX #***#
###   #  X    #***#
#     # X X X #***#
#    ###### ###***#
## #  #  X X  #***#
#  ## # XX X X##**#
# **# #  X      #*#
# **# # XXX XXX #*#
##### #       # #*#
    # ######### #*#
    #           #*#
    ###############