#########
#       #
# @X  * #
#       #
#########